....................
..@.......###$......
.##.........#.......
.......#............
.#...#..#...........
.#...##.#..###...#..
.........$.#....##..
..#......###....#...
..#......###........
....#....$.#........
...##....$.#.....#..
#...#....#.#........
###......#.#........
.........#..........
..#.##..............
..#..#......#.......
...........#........
.........$.#........
.........$.#........
.........$.#........