#..####.......#.....
.....#.$..###.##....
.##...$...##........
.##....#..#..##.$##.
.#...#..#...........
.#...##.#..###...#..
....###....#....##..
#.#.###..###.$#.#...
#.#...$..###........
#...#....$.#..#..#..
..###......#..##.#..
#...#...##.#..#..#..
###.###..#.#........
#...##..##...#.#....
..#.###.#..##..$....
.##.##..#.......##..
........#..#.#......
.##.#.#....#.#..####
.#....#...@#....#.##
...#.##..###........