##..###.#...###.....
##....$...##..$....#
.#.....#..##...#.###
....########...#.###
.#.#....#......#...#
.##.......#..$.#....
.#..#.##..######.#..
....#..#....#....#..
.#..##....@##..#..#.
.......#.##.........
..###...#...#..##...
.#.....$..#.#...##..
.....###......#..##.
..##...##.#####.##..
..#....#..#...#..#..
.##..#......$.#.##.#
..#..#.##.#####.....
........#........#..
...####.##.#.$..##.#
...####....#..#....#