####################
#.$......##......$.#
#.###.##.##.##.###.#
#........##........#
#.###.#......#.###.#
#.....#..##........#
####..##..@..##..###
#.....#.......#....#
#.#...#.#...#.#..#.#
#.#.....#.$.#....#.#
#.#.#.#.# $.#.#..#.#
#.#.#.#.#####.#..#.#
#..................#
#.#######..#######.#
#.#.....#..#....#..#
#.###.#.#..####.#..#
#...#.#.#..#....#.$#
#.$.#.#.#..####.##.#
#..................#
####################